#######
# o o #
# c   #
#     #
#######
