#######################
#            #        #
# ### ########### ### #
# #                 # #
# # #######  ###### # #
# # #               # #
# ### ########### ### #
# # #           # # # #
# # ### ####### # # # #
# # # # #     ### # ###
# # # # # ### # # # # #
# # # # ### #   # # # #
# #   # # # # # # # # #
# #   # #     # # # # #
# # # # ####### # # # #
# # # #         # # # #
  # # #############   #
# # #             #   #
#   ######## ###### # #
###   #             # #
# ################### #
#                     #
#######################