#######
#  c  #
#   o #
#  u  #
#######
